R 500 500

NO texture/bricks.xpm
SO texture/iron.xpm
WE texture/stone.xpm
EA texture/wood.xpm

S texture/ghost.xpm

F 50,50,50
C 100,200,255

        1111111111111111111111111
        1000000000110000000000001
        1011000001110000002000001
        1001000000000000000000001
111111111011000001110000000000001
100000000011000001110111111111111
1111111111111111111111111111
11110111111111011100000010001
11110111111111000001010010001
11000000110101011100000000201
10002000000000001100000010001
10000000000000001101010010S01
1100000111010101111101111000111
11110111 1110101 101111010001 
11111111 1111111 111111111111
